** *  **    
  ****      
**   *    * 
***    *  **
^           
  ***  * ** 
**      * * 
****  *   * 
* *      ** 
  * *  *  *$
