   * *****   **  ** ** ** * ** **       **    *   * *   ** *
 ***  * *    *** * *   *  ** * *       ** *** **       ** **
  ** *** ***       * * * * *  * *    ******   **     * ****$
* *** *** * **  * **  *    *  *   ** *  * *  ** ***  * * *  
*  *    *** * *  * ** * * ** ******        *******   *****  
*** ** * **** ***    ** * **** ** ***** * *  * * * * ** *** 
  *  ******** *** ***** *  ********  ** * ***  *  * ** ***  
*  ******** * *** * **    **** ***   ** * *     ** *   * ** 
*  **  * ** *   * **   **    *** * *      ** ** ** ******   
**   *    *** *** *   *  ** ***       ****   *   ** ******* 
 **    **  * *    ****** *** **** * ** ** *  * *  * *  **   
    *****    ******  * ***  * *   * **   *   * * ******     
** * ** ***** *  ***     *    ** **  *   ** ** **  ** *     
***  **   *  ****  **** ** * ****  *** * * **** *** * *** * 
**  ***  * **  **   ** ** *  ******* ***   *  *  ** **      
   * * * * * * * ****    ******* *  *   * *   ** * **** *** 
 ** ** * **  *   ***  ** * *  ** * **      ****  * *  *  ** 
 * *   ****  **       *   *    * * ********  ******  * ** * 
* * *   *  *  * * * *   *** *  * *  ***  *******  **  * * * 
*   ** *  * *   * * ***** * * * **** *   * **  **   ***   * 
 *     *   ***  ** ** * ** ******  **  * ******** ** *** *  
  ******   * **  *  ** *  *   * *****      **  * *  * * * * 
   ** ***** **** * *******      * *****    * * **  *** *    
   * ** * *** * **   *  * *  *  * *  ***  ** ** * * * * *** 
 *    *  ***  *** * * ** * * * *   ** ** ** **   ** * ***   
  **   ** **** ***  * ** **  *** * ** * ** *  * ** ** * *   
**  * * *** ***** * *  ** ** ** * ** **  *    ** **** *  ** 
******* ****   * *** *****  *  ** * *** **** *     * * * *  
 ** * * *** * * * * ** *** *     ** * * ** *   ****  ****** 
**** ******        *    ****   *       * ****   *   **  *   
 * * *** * **  *    **  * *  * * ** ***  * *  ***** * ** *  
*  *   ***** *  *    **    * * ** * * ******     *  *       
*** ** *  *** *    ****   * * * * ** * **** *  * ** *** *   
 **   ** *     * ****  *** * *  **** * ***   *      ***  *  
**         ** *  ** *           **   *    ***** *    ****   
**** **   ***   *  * * *** * * *  *  ******* **    *  * * * 
**    * *  ** * *****   ***  **** *  ************ **     ** 
** *  *     * **   * ****  * ** * *** *  ** *  *  * *** *** 
 * *  ********** * ** **  * *** * *  *  *   *****     ****  
**   *** ****** * * * * **  ****  *    ** **   ** **** *    
 * **** * **  ****  ** *   ** *    *    * * **   **  * **   
* **   **  ****  **  *   **   *** * *  * ***  * **** ** *** 
*  * *    *   **  ****** **    *   ** ** ** * * * ****   ** 
   ** *****  * * * * * ****** *  * ** *   *  *  ***      ** 
 ** ** **** **** *  ** *** ***    * *** *   ***  * *    *   
  **   * *  *****  *********  * *** ***  * ** ** ***  **  * 
  ** *    ****   **  * ***  ** *      *** *  *** **** *** * 
* ***** *  * *   * ***** **** ** * *  ***   *** ** ** * *** 
       * * *****   ** *        *  **  *** ** *  **  ***     
*    * * ** * ** ** **  ** ** **  ** ** ** ****   **        
  ***** *** ** *   *** ** *    * *** ** *** *   ******* *   
 **  **** *  *****    *  **  *   *  ***  *   *  *    ****** 
*** ** *   * *** **    ***** * * ** *  ** ** ***  **   *    
*** *****   **    * *** *  * **** * *  * *    * **   ***    
* ***** * **   ** ** ***   *** * *  * * **  **  ** *   **   
***  *  ***** ** *    **** ***    **  * ** *** **   **** ** 
  * *   *   * ***  **  * * * * **     *  *** *  *********** 
** * *  **   * ** * *   ***   **      * * *** * ***** ** ** 
*   ****   ****    *    **** *  **** ** ** ***** *  *    *  
       ***     * **** *  **  *** * ** *  *   * **  **    ** 
** * **  *** * ******        *  **** **   **     * *  ****  
 * * ***   ***  * *  *  ****** ****   * **   *** **       * 
  * ** ** * **  *  ***  *****  ***   * *     * *  ** ** * * 
 *** *   ***  ***  *  *  ** * **    * **   **   ****** * *  
  * ***  **    ****** *   *** ** *   * **       *  *  * *** 
 *   *** *****  *******  **  **   * *** *  **   *  ****  *  
 *  *  *** * *    **  *  ****  *  * *** *   *      * *    * 
* *    *   * ** *  * *** * * *   **  *  *  *    * **** *  * 
* * *** * **  * *     ** **         ***   * *  * * *   **** 
 ****     * * **  * ***   * *  *** *^                       
